OLGA       : LENARD     RODGERS    AIDA      
ROB        : ROBLES     WALLS      MABEL     
DORIS      : BUTLER     ELBERT     KENTON     JOSH      
WILLARD    : ODESSA     BUCK       DARNELL    MICAH      PETTY      STRICKLAND ISIAH      GONZALES  
WILLARD    : HOLLAND   
COLON      : ANDREA     HOOD       CASTRO    
MAVIS      : MONTGOMERY ROBBY     
LANDON     : ROBBINS    LOTT       RODERICK   TYLER     
KATHERINE  : FRIEDA     DONNY      GLADYS     MONA      
PAGE       : ROBBY      CHANG      BOWERS     STRONG     SALVATORE  FERRELL   
HOOPER     : ROMERO     ALTA       HOPKINS    DELORIS    TERRENCE  
OLIVER     : LUCIEN     ARRON      WELCH     
CASTILLO   : RODNEY     RONALD     ARMSTRONG  CRANE      BONNER     SUSIE      LANG      
TRENTON    : VERA       WHITAKER   FRANKLIN  
RAMSEY     : ODELL      HOLCOMB    KAUFMAN    BARBRA     MARTIN    
VILMA      : PEARSON    HIRAM      MOSS      
MCDONALD   : PAMELA     WILFREDO   HUMBERTO   MONROE    
PEARSON    : VILMA      KENT       BATTLE     VAUGHN    
WALTON     : GILBERT    MACIAS    
CARLSON    : THELMA     DEENA      GIBBS     
MARISOL    : IRWIN      FRYE       PATRICK    QUINN      HODGE     
LESTER     : LARSEN     FORBES     FRIEDA     LOTTIE     CAMACHO    ANTONIA    KRISTEN   
MANN       : DEJESUS    ALTON      REESE      JANETTE    CURTIS    
PERRY      : HOLMAN     LLOYD      HEAD      
KATY       : ODELL      TOM        JARROD     BRUNO     
MARK       : MICAH      CHAN      
ANTONE     : ELOISE    
JOHN       : KEVIN     
MAXWELL    : ROSARIO    GRAHAM    
ANNA       : CHARITY    MILLICENT  EARL       SANCHEZ    BARTON     HAYDEN    
LETITIA    : MONTOYA   
VALERIE    : SAUNDERS   FORREST    HUBBARD   
MCKAY      : HARDY      HOLMAN     DENA       VAN        OWEN      
PRINCE     : ALLISON    OLA        STACI     
LUCIEN     : OLIVER     JENNINGS   HIRAM      SOLIS      LOGAN      ANNABELLE 
CHANEY     : FLORES     ELLIOTT   
GILMORE    : BALDWIN    LEONEL     HERIBERTO  RAY        ONEIL      MOSLEY     HARPER    
LESLIE     : OLA        AYERS      BOYER      DAVENPORT 
MARION     : DIXIE      BOYLE      MACIAS    
GLENN      : DODSON     BRANDY     BONITA    
LEE        : REBEKAH    DAWN       WISE       ESTRADA    LOGAN     
HATFIELD   : AMIE       CUNNINGHAM SARA       SERGIO     LETICIA    MAE       
CRYSTAL    : WOLF       VAN       
LUCILLE    : STEFANIE   BEST       TATE       COTTON     ADDIE     
PATE       : GRETA      CLEVELAND  NORA       CINDY      LOTT       MARSHALL  
MONICA     : FANNIE     SOLIS      BOYLE      MCGOWAN   
LENARD     : OLGA       RICHARDS   EMILE      FLORENCE   FREDRIC   
RAMIRO     : STACIE     ELOISE     NEWTON    
PHOEBE     : KNOWLES    DAVIS      HELENA     BRIDGET   
FOX        : PICKETT    LEWIS      LETICIA    BOYLE     
ROBERTA    : DENIS      EFREN      HUDSON     HARRIET   
BENJAMIN   : WILCOX     JOHANNA    POOLE      DANIAL    
LEONOR     : ROBERT     TONIA     
TILLMAN    : KATHARINE  MARCELO    JEANNE     BRAY      
AVIS       : LETICIA    CHRISTINE  ERIK       LUCY       BETH      
ANDERSON   : DANIELLE   HOLCOMB    ROSEANN    ROBERT    
JENNINGS   : LUCIEN     HOLCOMB    TAMMIE     JOHNNIE   
LATONYA    : CLYDE      NIKKI      BUCKLEY    CEDRIC    
ODESSA     : WILLARD    LUCIANO    SAMPSON    SYBIL      KERR      
LILIANA    : CECIL      HAROLD     COMPTON    DAVENPORT 
LITTLE     : MASSEY    
MADELINE   : PERCY      MICHEAL    BETHANY    TERRENCE   TRUDY     
PERCY      : MADELINE   CHARITY    OLA        HARVEY     SARA       MOLINA     VERN      
WARD       : GREGORY    SALAZAR    QUINTON   
KNOX       : BLACKWELL  SYKES      DUNCAN    
FIELDS     : MOLINA     LANCASTER  ANDREWS    FREEMAN    FULLER     FAITH      NICHOLSON 
AMIE       : HATFIELD   FRY        GUTHRIE    ELBERT    
WITT       : MCLAUGHLIN ROYCE      MADDEN    
CANDICE    : ROJAS      MORENO     DELBERT   
MONTGOMERY : MAVIS      LAMBERT    AURELIA    OMAR       HAZEL      FAITH     
JANELLE    : JEFFERSON  BORIS      LON        LLOYD      REILLY    
HOLDEN     : BURGESS    MARGUERITE SHANNON    FAITH      MAYER     
DERICK     : CHANG      HARMON     SHELLEY   
MEREDITH   : LYMAN      DENA       PAT        DAMIAN     RANDALL    HOFFMAN   
WALTERS    : SALAZAR    TIMMY      BURRIS     TRUDY      MINNIE    
ABE        : CALDWELL   TRAN       JOSEPHINE 
JACKIE     : JODIE      LES        CONNER     DEAN       WONG      
COPELAND   : BYRD       DILLON     SALAZAR    LOWE       ESTELLA    MAYER      MILO      
ESTES      : KIP        HOMER      RORY       MERRILL   
HERRERA    : HOUSTON    TUCKER     WIGGINS    RONALD     POOLE     
THELMA     : CARLSON    ANDREA     BRIANA     NIEVES     ALISSA    
MILAGROS   : STEPHENS   ODOM       LINDSAY    ROBT      
ARIEL      : BERT       ISRAEL     JACOB     
MERCADO    : WELCH      SAMPSON    NORMA     
MCNEIL     : RICHARDSON RUSSEL    
SIMON      : LOURDES    HEIDI     
TODD       : BAKER      BARTON    
MARCELINO  : MYRA       BATTLE    
WILCOX     : BENJAMIN   ERIN       KRISTIE    ISRAEL     AMADO      RANDOLPH  
LEACH      : CARSON     DAVID      HOUSE     
IRIS       : LEWIS      RICO       TREY       HAWKINS    FERRELL   
INES       : CRISTINA   JOHNATHAN  SHERYL     TERRI      FRANCES    DELMAR    
WEBSTER    : SAM        LEWIS      ISIAH      MABEL      GENARO     LYNN      
RAMOS      : CLARA      FREEMAN    SHELLEY    MACIAS    
BLACKWELL  : KNOX       HERBERT    HURLEY     RODRIGUEZ  BRYAN     
ANIBAL     : COX        GRACIELA  
DONOVAN    : ERNESTINE  CURTIS    
LILA       : ANITA      KIDD       TORRES     KASEY      HILL      
HOBBS      : STACIE     DALE       ALVAREZ    EDWIN     
STACIE     : RAMIRO     HOBBS      KENNEDY    WENDI     
CHRISTI    : SCHNEIDER  SPENCE     SHAWN     
LOIS       : STEWART    WOODARD    GALLOWAY   BETH      
JAMAAL     : GILBERT    LYDIA      NORA       VALENTINE 
BALDWIN    : GILMORE    BAKER      MARIANA   
MONTY      : IRVIN     
HARRINGTON : WARNER     CARISSA    JESSE      GARNER     ELDON     
PICKETT    : FOX        MARY       LANCASTER  KRAMER    
EUGENIA    : ALFRED     MICHAEL    NATASHA   
SAM        : WEBSTER    CLYDE     
OCTAVIO    : GRIFFIN    STEFANIE   BUDDY      CHANCE     COLLINS   
HAMILTON   : STRICKLAND GALLOWAY  
CRISTINA   : INES       WEBER      FORBES     HICKS      ASHLEY     SYKES      ALEXANDRA  NOEMI     
CRISTINA   : BURKS     
BRENDAN    : DEWAYNE    RYAN       EFREN      AISHA      CORNELIUS 
BARRY      : GRETA      COMPTON    CORTEZ    
WARREN     : JOYCE      JOANNA     LATISHA    HAYS       JOSE       HILL      
HANNAH     : MCMILLAN   MARTINEZ   WILLIS     INGRAM     FLYNN     
ERIN       : WILCOX     CHELSEA    FRIEDA     NICHOLS    GERARDO    MARTHA     MOODY      IRA       
ERIN       : GRACIELA   JEANNE     ODONNELL  
HOUSTON    : HERRERA    DONA       ESMERALDA 
BELL       : ABRAHAM    CHERI      PAM        ISABELLA   STACY     
SWEET      : THOMPSON   MYERS      BRYAN     
BARLOW     : WOLFE      ARMSTRONG  ROBERTSON  TRENT     
DUNN       : GALEN      JONI       CALLAHAN  
LANA       : DICK      
YANG       : SLOAN      MALDONADO  ROCKY      SHAWN      BURKS      WELDON    
ANDY       : SLOAN      WEAVER     CALLAHAN   MATTHEWS  
HIRAM      : VILMA      LUCIEN     SARA       RANDALL    KELLY     
CONNIE     : IVANA      TUCKER     GARRY      SALINAS    MOISES    
BARNES     : ART        PARK       BENTLEY    MARIANO    ROWE       CASTRO    
JEFFERSON  : JANELLE    TASHA      DELMAR     MCINTYRE  
PAMELA     : MCDONALD   ADELINE    LANG      
MERCEDES   : RICHMOND   DUNLAP     LYNN      
HORTON     : WENDY      LENORA    
HERBERT    : BLACKWELL  KLINE      ALFONZO    GATES      CONSTANCE 
BARRERA    : BAIRD      HARMON     BAUER     
MCCONNELL  : BOYD       BUCKLEY    ONEIL     
ROSALIE    : SUSIE      CHARMAINE  MACK       ANGELITA  
CHARLOTTE  : MARA       LETICIA    GUTHRIE   
JILL       : KEITH      GRAY       DANIEL    
MAC        : DEANDRE    ISABELLE   STRICKLAND AMANDA     DANIELS    JESSE     
WALDO      : FANNIE     HURLEY     BRUNO     
LEVI       : GONZALEZ   CARR       VALENCIA   PUGH       TURNER    
WARNER     : HARRINGTON HENSON     CROSS      EARLENE    COX        OWEN      
HARRELL    : MARGARITA  DELANEY    DIXON      NELDA      MACK       KELLY     
GOMEZ      : EVANGELINA SAUNDERS   CEDRIC    
SOTO       : ROMERO     POPE      
ABRAHAM    : BELL       JOSE       CEDRIC     ALINE     
JIMENEZ    : EMORY      ROBBY      PENNINGTON LOTTIE     TORRES     MARISSA   
ALLISON    : PRINCE     GUY        ERNESTINE  MONROE    
BUCKNER    : HEIDI      OLSEN     
FREDERIC   : SHANA      STRONG     BRYAN     
COMBS      : AMANDA    
DODSON     : GLENN      ROBINSON   THOMAS     SHERMAN    GATES      ISIDRO    
REBEKAH    : LEE        DUKE       CHANCE     ODONNELL  
ROSETTA    : BAKER      CLAY       JIMMIE     BASIL      ARTHUR    
HARDY      : MCKAY      KARLA     
VELASQUEZ  : RUSSELL    ALFRED     SONNY      SAVANNAH  
WEBER      : CRISTINA  
BAIRD      : BARRERA    DARRELL    ODONNELL  
ALEXANDER  : GRETA      ASHLEE     FAULKNER   GRACE     
BRYON      : VELMA      TABATHA    THOMAS     KATHLEEN   DAVENPORT  ROYCE     
MARGARITA  : HARRELL    ROBINSON   DANIELS    NANNIE     BRUNO      GATES      KANE      
OCONNOR    : ERICKSON   TY        
ALVIN      : POPE       HENDERSON  NOEMI     
FOREST     : KAUFMAN    MUELLER   
CHARITY    : ANNA       PERCY      STEVENS    JOYNER    
COOKE      : MARYELLEN  NIGEL     
DIONNE     : STRICKLAND BRIGITTE   BARBER     MCGOWAN   
TRICIA     : MILLER     MARTHA     CANTU      KRYSTAL   
VERA       : TRENTON    ENRIQUE    FERN       CAIN       PETERSEN  
NUNEZ      : JOHNATHAN  HAZEL      HODGE      HOFFMAN   
ALBA       : ISSAC      HANSON     ALTON     
ISSAC      : ALBA       NICHOLS    MARCI      LIZZIE     COLLIN    
FLOSSIE    : ARRON      HERMAN     ORTIZ     
ELMA       : COOLEY     FRYE       CHRISTIAN 
BLEVINS    : FRY       
BUCK       : WILLARD    HARRIET   
NICOLE     : MIKE       BOB        CEDRIC     REGGIE    
MCMILLAN   : HANNAH     REEVES     WEAVER     TAMMY     
REEVES     : MCMILLAN   POTTS      SUSIE     
BYRD       : COPELAND   CARNEY     EARNEST    STEVENSON 
MOSES      : BEACH      DAREN      ERIK      
IRWIN      : MARISOL    DEANDRE    TERENCE    HUBBARD    BRIGGS    
CAITLIN    : MARIBEL    BERNADETTE
STEPHENS   : MILAGROS   WYATT      MUELLER    WALLER    
SYDNEY     : FRYE       STEELE     FRIEDA     JACKSON   
DINO       : AL         SANDOVAL   SHARRON   
CLEMENTS   : MILLICENT  GILL       CLARA      BROWN      COLLIN     OLSON     
MCCARTHY   : BRADLY     ELDON      LEMUEL    
OSCAR      : KNOWLES    REYES      DOMINGO   
GRIFFIN    : OCTAVIO    SOLIS      GABRIELA  
LUNA       : PITTS      GUY        ANNIE      DAWN      
MCKEE      : SCHNEIDER  ALTA       WILBUR    
IVANA      : CONNIE     BERTIE     AUGUSTINE  MILO      
BAKER      : TODD       BALDWIN    ROSETTA    HEATH      RITA       MCCRAY    
DEENA      : CARLSON    TAMMI      SUSANNA   
WINTERS    : TAMERA    
EMORY      : JIMENEZ    TOMMY      JARED      CORRINE    MARTIN    
ROBBIE     : NEWMAN     JOYCE      FLORINE    KERRI     
WEISS      : DONNA      MENDOZA    MCCARTY   
LAUREN     : SHERYL     MARKS     
ODELL      : RAMSEY     KATY       MARIA      OMAR      
KNOWLES    : PHOEBE     OSCAR      DONNY      KERI       MILO      
ROBBY      : MAVIS      PAGE       JIMENEZ    BASIL     
STUART     : CECELIA    INGRAM     CHANCE     MANNING   
OLA        : PRINCE     LESLIE     PERCY      GRACIELA   QUINTON   
GARTH      : LOURDES    MICHEAL    STEWART   
BEAN       : KELLY     
ANITA      : LILA       BERNADINE 
VELMA      : BRYON      MCCALL     LATISHA    FREDRIC    SARGENT    JAMAR     
KRISTIE    : WILCOX     GABRIELA   SCOTTIE   
ARRON      : OLIVER     FLOSSIE    WELCH      MCCALL     NIKKI      ASHLEY     OBRIEN    
JOHANNA    : BENJAMIN   JACLYN     AMELIA     LELIA      BOLTON     FAULKNER  
BETTE      : MARY       FERNANDEZ  BENTLEY    MYRA       REESE      AVERY      NIELSEN    TANYA     
ROBINSON   : DODSON     MARGARITA  SIMS       ROWE      
TABATHA    : BRYON      HANSON     MEADOWS    HENRY     
GRIMES     : SLOAN      CLYDE      GRACE      DUFFY     
DARNELL    : WILLARD    CHANG      ROXANNE    SHARON     LARSON     IRVIN      GRAHAM    
GILBERT    : WALTON     JAMAAL     ALTA       LEROY     
PITTS      : LUNA       SHELLEY   
SANTIAGO   : HAROLD     ADELINE    SAVAGE    
CLAYTON    : NANNIE    
GARRETT    : ROSS       CLARA      PHILLIP   
MARIA      : ODELL      KLINE      ANTHONY    BARTON    
FISCHER    : BUTLER     DANIELLE   KENNEDY    MCINTYRE   TORRES    
CARNEY     : BYRD       HUNTER     CAROLINE   HUNT      
DILLON     : COPELAND  
CASE       : PENNINGTON TARA       PARK       LELIA     
PITTMAN    : AUSTIN     MITCHELL   ETHEL     
SCHNEIDER  : CHRISTI    MCKEE      WOLF       BURTON     JOAN       GALLAGHER 
WYATT      : STEPHENS   JULIA      TERRI      EDWIN     
MCLEOD     : BORIS      GRETA      LINDSEY   
MCLAUGHLIN : WITT       ONEIL     
WELCH      : OLIVER     MERCADO    ARRON      HART       HEWITT    
MCKENZIE   : VICKI      LAURI      CLARENCE   NATASHA   
HART       : WELCH      BERTIE     DALE       VIRGIE     LIZZIE     CHARLENE  
SPENCE     : CHRISTI    NEAL       PAM        GEORGE     EVE       
PENNINGTON : JIMENEZ    CASE       DUSTY      CLEMONS   
JOHNS      : VICKY      ROCCO      DECKER     LIDIA      ONEIL      HUNT      
HANSON     : ALBA       TABATHA    BURGESS    HINES      WHITE     
NOLAN      : ANNIE      ROSARIO    FREEMAN    TRAVIS    
DEJESUS    : MANN       SCHROEDER  CAROL     
BURT       : YOUNG      MARGERY    HICKS     
HUNTER     : CARNEY     ETTA       LAUREL     DELACRUZ   JEANNE    
MICAH      : WILLARD    MARK       COX        POLLARD   
FANNIE     : MONICA     WALDO      BRIGITTE   TEDDY     
CORY       : CUNNINGHAM INGRAM    
REYES      : OSCAR      DIAZ       XAVIER     WILBUR     CHARLENE  
URSULA     : PHILLIPS   STEWART    WHITE     
JARVIS     : GREGORY    ENID      
JUSTINE    : COOK       DANIELS    SAVANNAH  
MARIBEL    : CAITLIN    VIRGIE    
RODNEY     : CASTILLO   FORBES     MARCELO    ROD       
HEBERT     : HANEY      BOYD       HOUSE      HENDRICKS  CAIN       BLAIR      ROSALES   
SILVA      : LAMBERT    BENTON     DEMETRIUS  ELINOR    
JACLYN     : JOHANNA    DOROTHEA   NIELSEN    SOSA       CHERRY     BRYAN      WONG      
PHILLIPS   : URSULA     KENT       JODIE     
TOBY       : DANIELLE   KERI       HULL       RITA       ADELINE    HOMER      PARKS     
GONZALEZ   : LEVI       KIM        BROCK      WATERS    
ELLIS      : RICE       ANNIE      LATISHA    SALAZAR    JARRED     RORY       MORROW    
CHARLIE    : MARIE     
HOLMAN     : PERRY      MCKAY      MELBA     
EDMUND     : PIERCE     KIM        SOFIA     
FRY        : AMIE       BLEVINS    SLOAN      MILES      BENTLEY    LANCASTER 
CARSON     : LEACH      PECK       KURT       KELLER     GONZALES  
HUGHES     : BRANDY     HANEY      BURKS      JOYNER     MCCLURE   
BURGESS    : HOLDEN     HANSON     ADAMS      REINALDO   HOWARD    
AUSTIN     : PITTMAN    RIOS       RENA      
PIERCE     : EDMUND     ALINE     
DENIS      : ROBERTA    ISABELLE   DAWN       BRUNO      HODGE     
CHANG      : PAGE       DERICK     DARNELL    CLARK      BONITA     LEANN      VALENTINE 
HINES      : HANSON     RODRIQUEZ 
TRACEY     : SEBASTIAN 
DARYL      : COLLEEN    BUCHANAN   KRAMER     BOWEN     
DIAZ       : REYES      JOYCE      FRANCESCA  DON       
CECELIA    : STUART    
LARSEN     : LESTER     JESSICA    ALI       
RICE       : ELLIS      TORRES     JACKSON    MORENO    
BRIAN      : RIVERA     ED        
JOHNATHAN  : INES       NUNEZ      FRANKS     RAY        BILLIE     DYLAN      KELLY     
BENNIE     : VINCENT    MERLE      KRISTEN    LORNA      ENID      
ERICK      : YOUNG     
LEANNE     : BERT       STEVEN     ESTELLA   
KENT       : PEARSON    PHILLIPS   NORMA     
COOLEY     : ELMA       STEELE    
TASHA      : JEFFERSON  BETHANY    SHARON    
BERT       : ARIEL      LEANNE     ALBERTO   
GUY        : ALLISON    LUNA       SERGIO     NELDA     
CLARK      : CHANG     
TUCKER     : HERRERA    CONNIE     AVA        TOWNSEND   BEASLEY   
VONDA      : ELVIRA     DIXIE     
FROST      : BURCH      ROBIN      ERNA       KRAMER    
NORTON     : ERIKA      WALSH      AUBREY     MAYNARD   
CRAFT      : SOLIS      LETICIA    COLLEEN    JARRED     DELORIS    BREWER     ALBERTO    STANLEY   
CRAFT      : BETH       TRACY     
LYDIA      : JAMAAL     RASMUSSEN  AURELIA    BIRD       DWIGHT    
FRYE       : MARISOL    ELMA       SYDNEY     CARMINE    GALEN      CLEVELAND  REILLY    
SELENA     : DEWAYNE    ANDREWS    DALTON     DAMON     
BRIDGETTE  : FORBES     MARGARITO 
WOLF       : CRYSTAL    SCHNEIDER  CECIL      PATEL     
THOMAS     : DODSON     BRYON     
YOUNG      : BURT       ERICK      HENSON     KENTON     GIBBS     
DEANDRE    : MAC        IRWIN      MEDINA     TIMOTHY    STEVEN     RICK      
KIM        : GONZALEZ   EDMUND     ISIDRO    
ENGLAND    : KRISTOPHER HORN       DELGADO   
CHELSEA    : ERIN       ZAMORA     FOSTER    
AGNES      : FLORES     ANA        EFREN      OLSEN      EVE        MCMAHON   
SILAS      : TERRY      SANFORD    KELLER    
MAGGIE     : ALTON      LELIA      EARLENE    DUKE       WILLIAMS   RANDOLPH  
HIGGINS    : LUCIANO    TAMMY      INGRAM    
TYREE      : GILL       DOYLE      ELVIRA     JULIET    
ELOISE     : ANTONE     RAMIRO     STANLEY   
TOM        : KATY       SALINAS    HARMON     BATTLE     HAYDEN    
MARGUERITE : HOLDEN     RASMUSSEN  RODRIQUEZ  ASHLEY     BARBER    
DEWAYNE    : BRENDAN    SELENA     BRADLEY   
FLOYD      : CANTRELL   KEVEN      QUINCY     VALENTINE  MCMAHON   
RICHARD    : ERNESTINE  MUELLER    GOODWIN    ROSALES   
EDITH      : BUTLER     FREEMAN   
WHITAKER   : TRENTON    ETTA       KERI       CHRISTIAN 
ANNIE      : LUNA       NOLAN      ELLIS      ISABELLE   JOSEPH     CORTEZ     KRAMER     REGINA    
FLETCHER   : JULIO      MILLIE     VICKI      HERSCHEL   TANYA     
CHRISTA    : LAUREL     SIMONE     SALVATORE  PARSONS   
LEONARDO   : BROWN      KIDD       TRAVIS    
LANGLEY    : SHERRI    
STEFANIE   : LUCILLE    OCTAVIO    SHEPARD    WILFORD    ERMA       HOUSE      LUISA      GRACIELA  
STEELE     : SYDNEY     COOLEY     LANCASTER  ASHLEY     KEVIN     
BARTLETT   : DIANE      GRAY       WATTS      HELGA     
KLINE      : HERBERT    MARIA      MEDINA     QUINCY     CAROLINE   AUBREY    
KRISTOPHER : ENGLAND    BURRIS     KRISTINE  
ETTA       : HUNTER     WHITAKER   MARYANNE   POTTS      RICHMOND   MASSEY     THADDEUS   BARNETT   
ISABELLE   : MAC        DENIS      ANNIE      SCHULTZ   
AMELIA     : JOHANNA    JUAREZ    
TARA       : CASE       LINDSAY    DELGADO   
ALTON      : MANN       ALBA       MAGGIE     BONITA     SALINAS    BARTON    
BALLARD    : HUGH       HAZEL      SANFORD    JIM        BOWMAN     NADINE     GEORGIA   
ROMERO     : HOOPER     SOTO       CARMINE    GALLAGHER  SAVANNAH   PARSONS   
RIVERA     : BRIAN      LORRAINE   SIMONE    
JOY        : CHANDLER   SCOTTIE    GILLESPIE  CUMMINGS  
ALTA       : HOOPER     MCKEE      GILBERT    DEANA      PATRICK    MATHIS     ELLIOTT   
MARIE      : CHARLIE    MILLICENT  NANNIE     PUCKETT    QUINN      COTE      
MCCULLOUGH : SCHWARTZ   ALISSA    
SEARS      : GABRIELA   ANA        FLEMING    HOWELL     ROYCE      BERNADINE 
NEWMAN     : ROBBIE     COLLIER    WALLER     BARR      
JODIE      : JACKIE     PHILLIPS   WOODARD    ROJAS      HOLLAND   
JAIME      : BRUNO      DUNCAN    
BROCK      : GONZALEZ   BONITA     CONRAD     DELGADO    LYNN       SAVAGE    
SLOAN      : YANG       ANDY       GRIMES     FRY        JAY       
NICOLAS    : RICHMOND   KRISTEN    PHELPS    
HENSON     : WARNER     YOUNG      BERGER    
CLAUDETTE  : IGNACIO    BETHANY    DALTON    
MILLICENT  : ANNA       CLEMENTS   MARIE     
RIOS       : AUSTIN     SEBASTIAN  LEONEL     WATTS      PETERSON  
XAVIER     : REYES      GRETA     
CONLEY     : CHAVEZ     JARROD     NOEL      
ROSE       : MARCY      GRACIELA   LOTT      
MARYANNE   : ETTA       FAULKNER   JARRED    
DAVIS      : PHOEBE     DONALD     SONNY      HODGE      SIMPSON   
POTTS      : REEVES     ETTA       LINDSAY    CLEVELAND 
MEDINA     : DEANDRE    KLINE      BARR       CARLA     
WIGGINS    : HERRERA    BOWERS     JOSUE     
BRANDY     : GLENN      HUGHES     GAY        CASEY     
BERTIE     : IVANA      HART       DOMINGO    MARCY     
BRIGHT     : CANTRELL   TRAN       SCOTTIE    MCMAHON   
FRANKS     : JOHNATHAN  TAMMY      MABEL      CLARENCE  
FORBES     : LESTER     CRISTINA   RODNEY     BRIDGETTE  FRANCIS    TRAN       BOBBI      ANASTASIA 
MARY       : PICKETT    BETTE      KARLA     
CARLENE    : WALSH      ROTH      
HARVEY     : PERCY      GRETA      JOSUE     
MILLER     : TRICIA     TERRI     
DARRELL    : BAIRD      DOYLE      NORA      
FEDERICO   : MAYS       EVANGELINA ADAMS      CARDENAS   SHELLEY   
LEWIS      : FOX        IRIS       WEBSTER    PARK       FREEMAN    JESSICA    KERRI     
CECIL      : LILIANA    WOLF       SHANA      BERNARDO  
RICO       : IRIS      
LUCIANO    : ODESSA     HIGGINS    JULIE      JOHNNIE   
FRIEDA     : KATHERINE  LESTER     ERIN       SYDNEY     GONZALO    DEMETRIUS  RUSSEL    
PETTY      : WILLARD    PAT        CHRISTINE  GLOVER    
TAYLOR     : BENTLEY    TAMMIE     TY        
ERIKA      : NORTON     CAMACHO    FLORINE    ROSEMARY   STEVENS    HUDSON     DEAN      
WILFREDO   : MCDONALD   INGRID     MARCELO   
STRICKLAND : WILLARD    HAMILTON   MAC        DIONNE    
CASANDRA   : RICHMOND   RICKY      LARSON     JULIE     
FREDDIE    : HEIDI      FLORINE    CLINT     
ISRAEL     : ARIEL      WILCOX    
AMANDA     : MAC        COMBS      BRENTON   
MOLLIE     : GLADYS     HURLEY     HERIBERTO  AIDA      
GILL       : CLEMENTS   TYREE      CALDWELL   YVETTE     LIDIA      FINLEY     BRYAN     
BONITA     : GLENN      CHANG      ALTON      BROCK      DAWN       EVERETT    SAUNDERS   SARGENT   
GARRY      : CONNIE     CARLO      TORRES     DALTON    
JORDAN     : FARLEY     PETER      LATISHA    MCCRAY    
KATHY      : TY        
DAPHNE     : JONI       EVANGELINA TERRY      STACY     
WALSH      : NORTON     CARLENE    RYAN       BOB        AURORA     CALVIN     MARCIA    
ANDREA     : COLON      THELMA     JANICE    
TAMERA     : WINTERS    SHERYL     SWANSON   
NOE        : ODOM       NETTIE     JESSIE     ANDREWS   
GIOVANNI   : SEBASTIAN  CATHRYN    COMPTON    ELIJAH    
WILL       : SWANSON    BARNETT   
JOYCE      : WARREN     ROBBIE     DIAZ       HAROLD     ENGLISH    CHRISTIAN  NICHOLSON 
WHITLEY    : HOLLIE     HUGH       BRIDGET   
WEEKS      : TORRES     COFFEY    
HILARIO    : ORR        WILLIS     BARKER     REESE      MERLE      ERIK      
CHAN       : MARK       BOYLE      KNIGHT     HOFFMAN   
BEST       : LUCILLE    JAMAR      LOGAN     
FLORES     : CHANEY     AGNES      VERNON     FREDERICK  SOFIA      MARISSA   
JOANNA     : WARREN     GILLESPIE  LENORA     OBRIEN    
DONNY      : KATHERINE  KNOWLES    KIP        TABITHA   
BRADLY     : MCCARTHY   MARCELO    BULLOCK   
BUTLER     : DORIS      FISCHER    EDITH      WEAVER     HERIBERTO  ELINOR    
VASQUEZ    : CAROLYN    NOEMI     
NICHOLS    : ERIN       ISSAC      ANNETTE   
KERRY      : IGNACIO    ENID       KANE      
BORIS      : JANELLE    MCLEOD     ROBT       HUMBERTO   HOLLOWAY  
VICKY      : JOHNS      KERI       GILES      DEAN      
COOK       : JUSTINE    ALVAREZ    DUSTY     
ROY        : LUISA      MERCER     THADDEUS   CONSTANCE 
BOWERS     : PAGE       WIGGINS    CLARA     
HEATH      : BAKER      GARZA      LEONEL     WILKINSON  DELBERT   
STOUT      : BUDDY      SOLOMON    MERCER     HOGAN     
CLYDE      : LATONYA    SAM        GRIMES     IRVIN      BRIDGET   
DANIELLE   : ANDERSON   FISCHER    TOBY       STEVEN     TAMMIE     JOHNSON   
PHILIP     : AUGUSTINE  HENRY      QUINN      CURTIS     NGUYEN    
HANEY      : HEBERT     HUGHES     JARROD     BARBRA    
RUTLEDGE   : AURELIA    DECKER    
DONA       : HOUSTON    PARK       LESSIE    
LOURDES    : SIMON      GARTH      HENDERSON  SCHWARTZ   POOLE     
MCFADDEN   : SCOTT      RICKY      LAWSON    
TIMOTHY    : DEANDRE    NORRIS     GINGER     WALL       THADDEUS  
DIANE      : BARTLETT   CUNNINGHAM WILEY      GRAY       ROBERTSON 
NEAL       : SPENCE     CRANE     
KATHARINE  : TILLMAN    RICHARDS   ROBBINS   
KRISTINA   : WILLIAMS   ELDON      GUZMAN     BATTLE    
BOBBIE     : ED         WINFRED   
MANUEL     : ROMAN      CLAUDIA   
ANNMARIE   : WALTER     TATE       FORREST    NATASHA   
SCOTT      : MCFADDEN   DAMIAN     SUSIE      KELLER     FRANKLIN  
PECK       : CARSON     REYNOLDS  
CANTRELL   : FLOYD      BRIGHT     DELACRUZ   PAYNE     
JULIO      : FLETCHER   JACOB      HECTOR     RENA      
ABEL       : GLADYS     LAMBERT    MEADOWS    LARSON     REFUGIO    HERRING    CARLA     
ROCCO      : JOHNS      HOLT       HERIBERTO  NEWTON     MARIANO    ROSALES    SELLERS   
FIGUEROA   : GALEN      WILLIAMS   ADAMS      PATRICK    CURRY      CANDY     
JULIA      : WYATT      HUGH       KAUFMAN    RICKY      JULIET    
HENSLEY    : OMAR       BOWMAN    
ROXANNE    : DARNELL    CARR       LENORA     ANASTASIA 
BURTON     : SCHNEIDER 
GLADYS     : KATHERINE  MOLLIE     ABEL       MARTINEZ   GLASS      TRUDY      WHITE     
SIDNEY     : WOODWARD   FOREMAN    NIELSEN    ALYSON     SCHROEDER  TRUDY      CARLA     
WOODWARD   : SIDNEY     TIMMY      JOHNSON   
LAMBERT    : MONTGOMERY SILVA      ABEL       MCCORMICK  OWEN      
DEANA      : ALTA       BENTON     HENRY     
CAROLYN    : VASQUEZ    DUNCAN    
CUNNINGHAM : HATFIELD   CORY       DIANE      EVANGELINA LORNA     
SARA       : HATFIELD   PERCY      HIRAM      DALE       RICHMOND   BENITO     DIXON      PATSY     
KERI       : KNOWLES    TOBY       WHITAKER   VICKY      ALI        ADDIE      DELBERT   
GONZALO    : FRIEDA     FERNANDEZ  ROBIN      SNOW       CORTEZ    
DOYLE      : TYREE      DARRELL    JESSE      GOODWIN   
ADAM       : AL         HOLT      
IGNACIO    : CLAUDETTE  KERRY      FRANCESCA  ELIZA      GONZALES  
GREGORY    : WARD       JARVIS    
WOLFE      : BARLOW     AL         ELIJAH     MARIANO    TYLER     
MILES      : FRY        BRAY       LANG      
HORN       : ENGLAND    REGGIE    
MORRIS     : ALFRED     SHELLEY   
STARK      : JANINE     LOWE       WATTS      PATSY     
LORENZO    : KEVEN      MCCRAY     IAN       
KENNEDY    : STACIE     FISCHER    RAYMOND   
ROBLES     : ROB        SANTANA    VARGAS    
LEBLANC    : CEDRIC     WONG      
REUBEN     : GENARO     HARRIS    
LYMAN      : MEREDITH   ROSA       SONNY     
DALE       : HOBBS      HART       SARA       FAULKNER   MCINTYRE   HURST     
DARCY      : MYRA       GLORIA     CONCEPCION EARNEST    RUSSO     
SERGIO     : HATFIELD   GUY        BERNARDO   RANDOLPH  
DONNA      : WEISS      ELISEO     LARSON     JOSE      
ENRIQUE    : VERA       SAMUEL     CARR       JACKSON    GEORGIA    RODERICK  
SHERYL     : INES       LAUREN     TAMERA     NANNIE     DWIGHT     LAWANDA   
MARTINEZ   : HANNAH     GLADYS     ANASTASIA 
ART        : BARNES     INGRAM     SCHROEDER  BRADFORD  
LOTTIE     : LESTER     JIMENEZ    STANTON    KNIGHT    
CHERI      : BELL       MOSS       SHEPARD    SUSANNA    GLOVER    
COLLIER    : NEWMAN     KIP        PRESTON    YVETTE    
HINTON     : BONNER    
HUBER      : DECKER     MAXINE     AYALA     
MIKE       : NICOLE     BRIGITTE  
RONALD     : CASTILLO   HERRERA    WILKINSON  MILDRED    WELDON     TY        
MCCALL     : VELMA      ARRON      DECKER     VAN        CASEY     
ALFREDA    : KEITH      SYBIL     
KARYN      : GEORGE    
THOMPSON   : SWEET      LORNA      KELLY     
HURLEY     : BLACKWELL  WALDO      MOLLIE     OTTO       MAYER     
HULL       : TOBY       HUFFMAN    REGGIE    
MARCI      : ISSAC      FERRELL    KANE      
TAMMI      : DEENA      TREY       EFREN      COX        GIBSON     SIMPSON    TRACY     
ELISEO     : DONNA      LETICIA    HUFFMAN   
CAMACHO    : LESTER     ERIKA      BROWN      DAREN     
LENORE     : VAN        PALMER     CHARLES   
BOYD       : MCCONNELL  HEBERT     HOMER      BIRD       LEON      
HEIDI      : SIMON      BUCKNER    FREDDIE    ARNULFO    AYALA     
CARISSA    : HARRINGTON LACY       MACDONALD  HOWARD    
MALDONADO  : YANG       HURST     
CARMINE    : FRYE       ROMERO     BRADSHAW   GENARO     EVAN       TONI      
PAULETTE   : BOYER      TREVINO   
HOPKINS    : HOOPER    
MARYELLEN  : COOKE      MARGARITO  WILKINSON  CHANCE     ANDREW    
MOSS       : VILMA      CHERI      JASPER     SHEPHERD   MILLS      LOTT       RANDALL   
CHANDLER   : JOY        TREY       JUAREZ    
GRETA      : PATE       BARRY      ALEXANDER  MCLEOD     XAVIER     HARVEY     FOREMAN    DUKE      
GRETA      : ALFONZO    MARCIA    
LORRAINE   : RIVERA     PRUITT     VINCENT    WALL       CLEMONS   
RASMUSSEN  : LYDIA      MARGUERITE WILFORD    MEADOWS    CARVER     POLLARD    KERR      
CROSS      : WARNER     COLLINS   
AYERS      : LESLIE     SHANNON   
BEACH      : MOSES      ELBERT     JACKSON    NICHOLSON 
ODOM       : MILAGROS   NOE        SONYA      BRADLEY    ELVA       CUMMINGS   FLYNN     
KENDALL    : REYNA      LINDSAY    CASSIE    
PAM        : BELL       SPENCE     EMILE      PRISCILLA  ROSARIO   
VICTORIA   : NIGEL      CARR       GOLDIE     JULIE     
DENA       : MCKAY      MEREDITH   GILES      JAMAR      PALMER    
LANE       : SUZETTE   
SUAREZ     : LACY       JEREMY     WILKERSON 
MARA       : CHARLOTTE  SHANA      LINDA      DWIGHT    
CLAY       : ROSETTA   
HOLLIE     : WHITLEY    ZAMORA     EARLE      KANE      
CHAVEZ     : CONLEY    
LES        : JACKIE     OMAR       GOOD       HERSCHEL  
THURMAN    : MCCORMICK  ADKINS     CUMMINGS   SELLERS   
HUGH       : BALLARD    WHITLEY    JULIA      PRUITT     CRAIG      OTTO       PASQUALE  
SCHULTZ    : ISABELLE   DENNIS     MINNIE     FINLEY    
SAMUEL     : ENRIQUE    MAE        PETERSON   CLARENCE   GREENE    
FRANCESCA  : DIAZ       IGNACIO    TYLER      KERR      
HOLCOMB    : RAMSEY     ANDERSON   JENNINGS   SOLIS     
SHANA      : FREDERIC   CECIL      MARA       BOB       
BUDDY      : OCTAVIO    STOUT      HENDRIX    SUZETTE    PATSY     
NIGEL      : COOKE      VICTORIA   PHELPS     DANA      
MILLIE     : FLETCHER   ROOSEVELT  HOWELL    
RICHARDS   : LENARD     KATHARINE  HENDERSON  AUGUSTINE  RORY       ESTELLA   
BERGER     : HENSON     ROBIN      NIKKI     
BURCH      : FROST      FOWLER     TERRI      PATRICK   
SOLIS      : LUCIEN     MONICA     GRIFFIN    CRAFT      HOLCOMB    WALL      
FARLEY     : JORDAN     BOBBI      CORTEZ     TERENCE   
DOMINGO    : OSCAR      BERTIE     MALLORY    FERN      
DOROTHEA   : JACLYN     PATEL      INGRID    
ELIZA      : IGNACIO    PORTER     STEVEN     DELMAR     ENID      
RODRIGUEZ  : BLACKWELL  FRANCES    SHIRLEY    BUCHANAN   KEVIN     
JOSEPH     : ANNIE      WALLER     WHITNEY    BRIGGS    
GALEN      : DUNN       FRYE       FIGUEROA  
MOLINA     : PERCY      FIELDS     JAY        CASSIE    
RICARDO    : MCCARTY    NAVARRO   
CARMELO    : BENTON     SALVATORE  TANNER    
RODGERS    : OLGA       REILLY     CHARLES   
ORR        : HILARIO    EVERETT    AYALA     
DAWN       : LEE        LUNA       DENIS      BONITA     CUMMINGS  
PETER      : JORDAN     SCOTTIE    ALFRED     HAYDEN    
LULU       : LORI       BONNER     COLLINS   
TREY       : IRIS       TAMMI      CHANDLER   WHITNEY    HERRING    GRAHAM    
HENDRIX    : BUDDY      CINDY      KRAMER     MACIAS     NGUYEN    
SUSAN      : JOSE       LAWANDA   
LUPE       : BOWMAN    
JONI       : DUNN       DAPHNE     AVA        BRADLEY    TRACY     
HERMINIA   : SIMS       DAMIAN    
EVERETT    : BONITA     ORR        LYNN       KANE      
WEAVER     : ANDY       MCMILLAN   BUTLER    
NETTIE     : NOE        RAY        YVETTE    
WILLIS     : HANNAH     HILARIO    BRANDI    
VERN       : PERCY      AURORA     FERRELL    EVE       
RITA       : BAKER      TOBY      
EMILE      : LENARD     PAM        VEGA      
FERNANDEZ  : BETTE      GONZALO   
ALVAREZ    : HOBBS      COOK       DENNIS     SHARON     EARLE      WATERS     JAY        BLAKE     
ED         : BRIAN      BOBBIE     BOOTH      MARCIA    
BOYER      : LESLIE     PAULETTE   EARL       WELLS      REYNOLDS  
FLORINE    : ROBBIE     ERIKA      FREDDIE   
FOWLER     : BURCH      GOLDIE     PETERSEN  
LATISHA    : WARREN     VELMA      ELLIS      JORDAN    
LETICIA    : HATFIELD   FOX        AVIS       CHARLOTTE  CRAFT      ELISEO     HOLT       DANIEL    
CARLO      : GARRY      MELBA      BASIL      RANDALL   
CONRAD     : BROCK      ELDON      LANG       RUSSEL    
ELVIRA     : VONDA      TYREE      HOLT      
MERLIN     : RODRIQUEZ  FREDRIC    TERRELL    KRISTINE  
KOCH       : TERRY     
PARK       : BARNES     CASE       LEWIS      DONA       DUNCAN     MARVIN    
KEVEN      : FLOYD      LORENZO    MABEL      ISABELLA   MATHIS     KNIGHT    
ARMSTRONG  : CASTILLO   BARLOW     FAULKNER   ERNIE      TANYA      HEAD      
KURT       : CARSON     HENRIETTA  FREDERICK  RACHAEL   
ZAMORA     : CHELSEA    HOLLIE     JAYNE     
SEBASTIAN  : TRACEY     RIOS       GIOVANNI   GUTHRIE    ASHLEY     SIMONE    
AL         : DINO       ADAM       WOLFE      CRAIG      DURAN      COLLINS   
MARCUS     : MENDOZA    MONROE    
MICHEAL    : MADELINE   GARTH      MARTHA     LEONEL     RICK      
BLANCHARD  : DWIGHT    
TREVINO    : PAULETTE   GOOD       CEDRIC     ROD        WINFRED    MCBRIDE   
DUSTY      : PENNINGTON COOK       PUGH       MINNIE     MOSLEY    
BRIGITTE   : DIONNE     FANNIE     MIKE       JULIE     
ROSS       : GARRETT    ROBBINS    FREEMAN    MARVIN     ROTH       RACHAEL   
SONYA      : ODOM       WATERS     BERNARDO  
LELIA      : JOHANNA    CASE       MAGGIE    
ROSEANN    : ANDERSON   CARROLL    DORA      
OTIS       : BRUCE      TERRELL   
NORRIS     : TIMOTHY    COLLIN     GATES     
SALAZAR    : WARD       WALTERS    COPELAND   ELLIS      GOOD      
MAE        : HATFIELD   SAMUEL     LOTT       BLAIR     
WILEY      : DIANE      LAWSON     CROSBY    
LEVINE     : KATHLEEN   BOB        GUTHRIE    STEVENS   
NITA       : HOLDER     BONNER     STRONG     LYNN      
CATHERINE  : CATHRYN    LEROY     
BARKER     : HILARIO    DAMON     
JESSIE     : NOE        LAUREL     CONSTANCE 
PATEL      : WOLF       DOROTHEA  
LORI       : LULU       ROBT      
TERRI      : INES       WYATT      MILLER     BURCH     
MAYS       : FEDERICO   CONSTANCE 
FOREMAN    : SIDNEY     GRETA      LINDSEY   
ROCKY      : YANG       RODERICK  
GERARDO    : ERIN      
FRANCES    : INES       RODRIGUEZ  HECTOR     ADKINS    
EDGARDO    : GARZA      RICHMOND   DELGADO    IRVIN      LAWSON     PHELPS    
PORTER     : ELIZA      ERNESTINE 
NANETTE    : HOLT       BOLTON     COLLIN     MAYER      NADINE     ERNIE     
PACHECO    : BOWMAN    
KATHLEEN   : BRYON      LEVINE     FERN       HARRIET   
SHIRLEY    : RODRIGUEZ  LEMUEL     NOEL       PETERSEN  
AURELIA    : MONTGOMERY LYDIA      RUTLEDGE   MCLEAN    
POPE       : SOTO       ALVIN      CHUCK     
VICTOR     : CARR       LOWE       JAYNE      WENDY     
DANIELS    : MAC        MARGARITA  JUSTINE    NOELLE    
MARTHA     : ERIN       TRICIA     MICHEAL    SIMS       WENDY      JEAN       KEVIN     
BRIANA     : THELMA     MCCORMICK  HENRY     
REYNA      : KENDALL    CRANE      BRUCE      LENORA     CHARLES   
QUINCY     : FLOYD      KLINE      WILLIE    
HOLDER     : NITA       VICKI     
NAPOLEON   : MALLORY    JEREMY     MOISES     DEAN       GREENE    
GABRIELA   : GRIFFIN    KRISTIE    SEARS      HOOD      
BETHANY    : MADELINE   TASHA      CLAUDETTE  DELANEY    ROYCE     
SHEPARD    : STEFANIE   CHERI      GRACIELA   JOHNSTON  
LAUREL     : HUNTER     CHRISTA    JESSIE     MCCLURE   
FLORENCE   : LENARD     ALBERTO   
ROSA       : LYMAN      WALTER     WATTS      HOWELL     MAURICE   
HAROLD     : LILIANA    SANTIAGO   JOYCE      LINDA      COLLEEN    EMILY      MARCELO    MARKS     
SANDOVAL   : DINO       ESTEBAN    HELGA      GREENE    
HENRIETTA  : KURT       CURRY      REGINA    
WHITFIELD  : TONI       HEAD      
CLARA      : RAMOS      CLEMENTS   GARRETT    BOWERS     DELACRUZ   FLEMING   
FULTON     : VERNON     AUTUMN    
ROBIN      : FROST      GONZALO    BERGER     ANNABELLE 
WALTER     : ANNMARIE   ROSA       VICKI      TONI      
JANINE     : STARK      MORROW     RICHARDSON
BENTLEY    : BARNES     BETTE      FRY        TAYLOR     GLASS      FREEMAN   
JASPER     : MOSS      
ERNESTINE  : DONOVAN    ALLISON    RICHARD    PORTER     FREDERICK  JULIAN    
GARZA      : HEATH      EDGARDO    PETERSEN  
EVANGELINA : GOMEZ      FEDERICO   DAPHNE     CUNNINGHAM SAVANNAH  
SHAWN      : CHRISTI    YANG       GOOD       NOEMI     
INGRID     : WILFREDO   DOROTHEA   TABITHA   
LINDA      : MARA       HAROLD     JERALD    
SIMS       : ROBINSON   HERMINIA   MARTHA     PRESTON    TINA      
MURIEL     : MYERS      MARIANO   
ANNETTE    : NICHOLS    SANCHEZ   
LORIE      : PRUITT     JESSE      KANE      
MYRA       : MARCELINO  BETTE      DARCY      BONNER     NIELSEN   
GLASS      : GLADYS     BENTLEY   
LINDSAY    : MILAGROS   TARA       POTTS      KENDALL    CARR       GRACIELA  
ROBT       : MILAGROS   BORIS      LORI       ERNA      
PRUITT     : LORRAINE   HUGH       LORIE     
FOSTER     : CHELSEA    HAZEL      ALEXANDRA 
VINCENT    : BENNIE     LORRAINE  
NOELLE     : DANIELS    ANA        LACY       FREDERICK  ADDIE     
GOODMAN    : ESTELLA    DUFFY     
RYAN       : BRENDAN    WALSH      SUSANNA    STEVENSON 
RICHMOND   : MERCEDES   ETTA       NICOLAS    CASANDRA   SARA       EDGARDO   
LUCAS      : MINNIE    
DYER       : HICKS      TANIA      PHILLIP    CARLA     
RUSSELL    : VELASQUEZ  PUCKETT    BARTON     REILLY    
BOB        : NICOLE     WALSH      SHANA      LEVINE     BOOTH      LORNA      LEROY      VAUGHN    
MARIANA    : BALDWIN    TOMMY      LORENA     HAWKINS   
CRANE      : CASTILLO   NEAL       REYNA      STEVEN     CORRINE   
ADELINE    : PAMELA     SANTIAGO   TOBY       DAMIAN    
GINGER     : TIMOTHY    ERIK      
NANNIE     : MARGARITA  CLAYTON    MARIE      SHERYL     NEWTON    
MALLORY    : DOMINGO    NAPOLEON   LOWE       MARTIN    
REESE      : MANN       BETTE      HILARIO   
WILBUR     : MCKEE      REYES      CHRISTIAN 
CLEVELAND  : PATE       FRYE       POTTS      ANGELITA   MERRILL   
HOLT       : ROCCO      ADAM       LETICIA    ELVIRA     NANETTE    KAUFMAN    DARIN      SCHWARTZ  
LEONEL     : GILMORE    RIOS       HEATH      MICHEAL    JAYNE     
BOOTH      : ED         BOB        STACI      ERMA       BRENTON    ANTHONY   
FERN       : VERA       DOMINGO    KATHLEEN   COLEMAN   
CALDWELL   : ABE        GILL       BRUCE      DELACRUZ   WEBB      
WILFORD    : STEFANIE   RASMUSSEN  HURST     
HENDERSON  : ALVIN      LOURDES    RICHARDS   WILLIAMS  
LANCASTER  : FIELDS     PICKETT    FRY        STEELE    
MARGARITO  : BRIDGETTE  MARYELLEN  ERICKA     VANCE     
BOLTON     : JOHANNA    NANETTE    DYLAN      SHERMAN   
BRUCE      : OTIS       REYNA      CALDWELL  
DENNIS     : SCHULTZ    ALVAREZ    ISABELLA   LE         OBRIEN    
HAYS       : WARREN     DELMAR     DEAN      
SUZETTE    : LANE       BUDDY     
BROWN      : CLEMENTS   LEONARDO   CAMACHO    ANTONIO   
KELLEY     : DELACRUZ   EMILY      WILKERSON  BULLOCK   
RODRIQUEZ  : HINES      MARGUERITE MERLIN     CALLAHAN   ENGLISH    ROMAN      MARCEL     DANA      
JERALD     : LINDA      BARNETT    CHARLES   
DELACRUZ   : HUNTER     CANTRELL   CLARA      CALDWELL   KELLEY    
FREDRIC    : LENARD     VELMA      MERLIN     JIMMIE    
ANA        : AGNES      SEARS      NOELLE     PATRICK    EVAN      
JIMMIE     : ROSETTA    FREDRIC    JACOBS     GLOVER    
MYERS      : SWEET      MURIEL     LUISA      STACY     
EARL       : ANNA       BOYER      WENDY     
VIRGIE     : HART       MARIBEL    ERNIE     
STEVEN     : LEANNE     DEANDRE    DANIELLE   ELIZA      CRANE      VAUGHN    
ANTONIA    : LESTER     VICKI      IRVIN      GENARO     ALFONSO   
LIZZIE     : ISSAC      HART      
CATHRYN    : GIOVANNI   CATHERINE  DANIAL    
MARGERY    : BURT       MCCORMICK  WATERS    
SNOW       : GONZALO    INGRAM     DEWITT     STEVENSON 
WISE       : LEE       
AUGUSTINE  : IVANA      PHILIP     RICHARDS   CHERRY     KELLER    
GLORIA     : DARCY      MERRITT   
CONTRERAS  : ERICKA     CLINT      HOGAN      CLAUDIA   
FLEMING    : SEARS      CLARA      MITCHELL  
CAMERON    : CALVIN     ORTIZ      STEVENSON  DEVON     
ESMERALDA  : HOUSTON   
HICKS      : CRISTINA   BURT       DYER       ELIJAH     STEVENSON  CARLA      LESSIE    
OMAR       : MONTGOMERY ODELL      HENSLEY    LES        MERLE      CINDY      ALBERTO    LAWSON    
OMAR       : JAMEL     
GEORGE     : SPENCE     KARYN     
AURORA     : WALSH      VERN       CONNER     CHARMAINE  KRAMER     HUNT      
PRISCILLA  : PAM        NANCY      RACHAEL   
CALLAHAN   : DUNN       ANDY       RODRIQUEZ  DUKE       ROBBINS    MABEL      WALL       FUENTES   
ROSEMARY   : ERIKA      DALTON     GLOVER     ANGIE     
FRANCIS    : FORBES     BURRIS     DARIN      MANNING   
TAMMY      : MCMILLAN   HIGGINS    FRANKS     BERNADETTE TAMMIE     HENDRICKS  PETERSON   MINNIE    
LEANN      : CHANG      BENTON    
ERICKA     : MARGARITO  CONTRERAS  JARRED     CUMMINGS  
JANETTE    : MANN       FREEMAN    MADDEN     WELDON    
EARLENE    : WARNER     MAGGIE     LARSON    
JACOB      : ARIEL      JULIO      HERIBERTO  COX        JARRED    
CONNER     : JACKIE     AURORA     BURRIS     JIM        ESTELLA    BETH      
DELMAR     : INES       JEFFERSON  ELIZA      HAYS       WOODARD   
TATE       : LUCILLE    ANNMARIE   MCLEAN     HEWITT     HEAD       BRIGGS    
KIP        : ESTES      DONNY      COLLIER    COX       
WALLS      : ROB        AYALA      HOGAN     
NIKKI      : LATONYA    ARRON      BERGER     BUCKLEY    SYBIL      HARMON     CUMMINGS  
GUTHRIE    : AMIE       CHARLOTTE  SEBASTIAN  LEVINE     WATERS     RAUL      
ASHLEE     : ALEXANDER  RICKY      MAYNARD   
MASSEY     : LITTLE     ETTA       BRADSHAW   CORINNE    JOSH       HOGAN      BOWEN     
TOMMY      : EMORY      MARIANA    CARROLL    JOAN      
STEVENS    : CHARITY    ERIKA      LEVINE     BARR      
COLLEEN    : DARYL      CRAFT      HAROLD     ADDIE     
VEGA       : EMILE      PRESTON    BOBBI      JAMEL      MONA      
TERRY      : SILAS      DAPHNE     KOCH      
NORA       : PATE       JAMAAL     DARRELL    MATHIS    
JESSE      : HARRINGTON MAC        DOYLE      LORIE     
ASHLEY     : CRISTINA   ARRON      MARGUERITE STEELE     SEBASTIAN  FULLER    
BERNADETTE : CAITLIN    TAMMY      CHERRY    
TIMMY      : WALTERS    WOODWARD  
JANICE     : ANDREA     HAZEL      CLAUDIA    PARKS     
MONTOYA    : LETITIA    JESSICA   
EFREN      : ROBERTA    BRENDAN    AGNES      TAMMI      SHERRI    
HERIBERTO  : GILMORE    MOLLIE     BUTLER     ROCCO      JACOB      SANTANA   
SHARON     : DARNELL    TASHA      ALVAREZ   
JUANITA    : PETERSON   MORENO     RUSSEL    
AHMED      : STANTON   
CARR       : LEVI       ROXANNE    ENRIQUE    VICTORIA   VICTOR     LINDSAY    CASSIE    
JARROD     : KATY       CONLEY     HANEY      GENEVA    
STEWART    : LOIS       GARTH      URSULA     GRACIELA   NORMA     
RAY        : GILMORE    JOHNATHAN  NETTIE     CAIN       DELBERT   
TRAN       : ABE        BRIGHT     FORBES     SIMONE    
MCCORMICK  : LAMBERT    THURMAN    BRIANA     MARGERY    BUCKLEY    MAURICE   
JUAREZ     : AMELIA     CHANDLER   WOODARD    JOYNER     NICHOLSON  KEVIN     
VALENTINE  : JAMAAL     CHANG      FLOYD      DAMIAN     FUENTES    SAVAGE    
SERRANO    : JACKSON   
DUKE       : REBEKAH    MAGGIE     GRETA      CALLAHAN   IAN        JOSUE     
HECTOR     : JULIO      FRANCES    GOLDIE     RORY      
LACY       : CARISSA    SUAREZ     NOELLE     WOODARD    BONNER    
AVERY      : BETTE      ADKINS     LE        
MELBA      : HOLMAN     CARLO      MENDOZA    JULIE     
GOLDIE     : VICTORIA   FOWLER     HECTOR     RAYMOND    BASIL      FERDINAND  DARRYL    
ISIAH      : WILLARD    WEBSTER    ANDREWS    BUCHANAN   CONSUELO   NICHOLSON 
JEREMY     : SUAREZ     NAPOLEON   JARRED     MICHAEL    BARR       LEROY      BARTON    
BARBER     : DIONNE     MARGUERITE KRYSTAL   
LOWE       : COPELAND   STARK      VICTOR     MALLORY    KYLE       CURRY     
ALFONZO    : HERBERT    GRETA     
BUCKLEY    : LATONYA    MCCONNELL  NIKKI      MCCORMICK  MINNIE    
CRAIG      : HUGH       AL        
ROBBINS    : LANDON     KATHARINE  ROSS       CALLAHAN  
MABEL      : ROB        WEBSTER    FRANKS     KEVEN      CALLAHAN   CARDENAS   ANASTASIA 
RUSS       : ALFRED     RONNY      HARRIET   
KIDD       : LILA       LEONARDO   WILLIE     KENDRA     DYLAN      COTE       DARRYL    
FAULKNER   : ALEXANDER  JOHANNA    MARYANNE   DALE       ARMSTRONG  KELLER    
SAMPSON    : ODESSA     MERCADO    WELLS      OLSON     
ANDREWS    : FIELDS     SELENA     NOE        ISIAH      GRACE     
SALINAS    : CONNIE     TOM        ALTON      HODGE      OLSEN      HERRING   
DELANEY    : HARRELL    BETHANY   
AVA        : TUCKER     JONI       PALMER     MCBRIDE   
NEIL       : ALYSON    
RAYMOND    : KENNEDY    GOLDIE     MANNING    MILO      
BUCHANAN   : DARYL      RODRIGUEZ  ISIAH      TY        
EMILY      : HAROLD     KELLEY     WILKINSON  JOSUE      WELDON    
CONCEPCION : DARCY      DAVID      ALISSA    
KAUFMAN    : RAMSEY     FOREST     JULIA      HOLT       JACOBS     FULLER    
BRADLEY    : DEWAYNE    ODOM       JONI      
JAYNE      : ZAMORA     VICTOR     LEONEL    
SIMONE     : CHRISTA    RIVERA     SEBASTIAN  TRAN       MOHAMED    DUNCAN     KNIGHT    
SHEPHERD   : MOSS       SOLOMON   
WILLIAMS   : MAGGIE     KRISTINA   FIGUEROA   HENDERSON  ERICKSON   LE        
MCINTYRE   : JEFFERSON  FISCHER    DALE       MUNOZ      MORENO    
WILKINSON  : HEATH      RONALD     MARYELLEN  EMILY     
CAROLINE   : CARNEY     KLINE      BIRD       MORENO    
HOMER      : ESTES      TOBY       BOYD      
PARRISH    : DAMON     
COX        : ANIBAL     WARNER     MICAH      TAMMI      JACOB      KIP        DEANNE     JEWELL    
STACI      : PRINCE     BOOTH     
JACOBS     : JIMMIE     KAUFMAN    SYBIL      MCCARTY   
ROSARIO    : MAXWELL    NOLAN      PAM        HOFFMAN    CHARLES   
MEADOWS    : TABATHA    ABEL       RASMUSSEN  DEANNE     GENARO    
BRADSHAW   : CARMINE    MASSEY     SAUNDERS  
MUELLER    : FOREST     STEPHENS   RICHARD    TRAVIS    
HAZEL      : MONTGOMERY NUNEZ      BALLARD    FOSTER     JANICE     MARISSA    REGINA    
JARRED     : ELLIS      CRAFT      MARYANNE   ERICKA     JACOB      JEREMY     WHITE     
BRUNO      : KATY       WALDO      MARGARITA  DENIS      JAIME      DUNCAN    
SWANSON    : TAMERA     WILL       GOOD       TYLER     
CARROLL    : ROSEANN    TOMMY      PAT        DORA      
VALENCIA   : LEVI       RORY      
PRESTON    : COLLIER    SIMS       VEGA       DIXON      ERICKSON  
PEREZ      : JEAN      
MARCELO    : TILLMAN    RODNEY     WILFREDO   BRADLY     HAROLD    
MILLS      : MOSS      
GENEVA     : JARROD    
ERMA       : STEFANIE   BOOTH      KRYSTAL   
TINA       : SIMS       HOWARD     DANA       ANNABELLE 
TOWNSEND   : TUCKER     ALINE      CAROLE    
BRENTON    : AMANDA     BOOTH     
DELORIS    : HOOPER     CRAFT      TONIA     
CANTU      : TRICIA     TORRES     BRIDGET    ROBERTSON 
PAYNE      : CANTRELL   PASQUALE  
ANTHONY    : MARIA      BOOTH     
DELGADO    : ENGLAND    TARA       BROCK      EDGARDO   
MCCRAY     : BAKER      JORDAN     LORENZO    WATERS     WILLIE    
FREEMAN    : FIELDS     RAMOS      NOLAN      EDITH      LEWIS      ROSS       BENTLEY    JANETTE   
ESTEBAN    : SANDOVAL   ANTONIO    KERR      
GRACE      : ALEXANDER  GRIMES     ANDREWS   
ADAMS      : BURGESS    FEDERICO   FIGUEROA   MCGOWAN   
RICKY      : CASANDRA   MCFADDEN   JULIA      ASHLEE     TANNER    
LORENA     : MARIANA   
KARLA      : HARDY      MARY       MARKS      GRAHAM    
WOODARD    : LOIS       JODIE      DELMAR     JUAREZ     LACY      
JARED      : EMORY      LON        ORTIZ      LUCY      
WELLS      : BOYER      SAMPSON    DIXIE      MCLEAN     HEWITT     MARVIN    
NEWTON     : RAMIRO     ROCCO      NANNIE     DAMON      CONSTANCE 
BURRIS     : WALTERS    KRISTOPHER FRANCIS    CONNER    
MARCY      : ROSE       BERTIE     ERICKSON   BARNETT   
BENITO     : SARA       SAUNDERS   JOHNSTON   BEASLEY   
LARSON     : DARNELL    CASANDRA   ABEL       DONNA      EARLENE    ALICIA     OTTO      
VICKI      : MCKENZIE   FLETCHER   HOLDER     WALTER     ANTONIA    MARIANO    KRAMER    
DONALD     : DAVIS      CLINT     
WENDY      : HORTON     VICTOR     MARTHA     EARL       LEONARD    WATERS     CORINNE    MICHAEL   
WENDY      : JILLIAN    ANDREW    
AUBREY     : NORTON     KLINE      SHELLEY   
DAVID      : LEACH      CONCEPCION GOOD       QUINTON   
COMPTON    : LILIANA    BARRY      GIOVANNI  
PUGH       : LEVI       DUSTY      BLAIR      ALISSA    
MENDOZA    : WEISS      MARCUS     MELBA     
KEITH      : JILL       ALFREDA    CURRY      SHELLEY   
MERLE      : BENNIE     HILARIO    OMAR       STEPHENSON
BREWER     : CRAFT     
VERNON     : FLORES     FULTON     SETH       DUFFY     
SCOTTIE    : KRISTIE    JOY        BRIGHT     PETER     
ALICIA     : LARSON     GILLESPIE  CORINNE    BERNARDO   ANNABELLE 
EARLE      : HOLLIE     ALVAREZ    MARIANO    LEON      
IAN        : LORENZO    DUKE       BRANDI     COTTON     HOOD      
JEAN       : MARTHA     PEREZ      GILES      MARTIN     TY        
SAUNDERS   : VALERIE    GOMEZ      BONITA     BRADSHAW   BENITO    
DECKER     : JOHNS      RUTLEDGE   HUBER      MCCALL     REINALDO  
JOSUE      : WIGGINS    HARVEY     DUKE       EMILY      HAWKINS    LUCY       JULIAN     ALFONSO   
SYKES      : KNOX       CRISTINA  
MILDRED    : RONALD     CARDENAS  
SYBIL      : ODESSA     ALFREDA    NIKKI      JACOBS    
DEANNE     : COX        MEADOWS    TABITHA   
BONNER     : CASTILLO   HINTON     LULU       NITA       MYRA       LACY      
NIELSEN    : BETTE      JACLYN     SIDNEY     MYRA       AYALA     
ENGLISH    : JOYCE      RODRIQUEZ  REGGIE     ALISSA    
HOUSE      : LEACH      HEBERT     STEFANIE   ELLIOTT   
LEONARD    : WENDY      FRANKIE   
WATERS     : GONZALEZ   ALVAREZ    SONYA      MARGERY    GUTHRIE    MCCRAY     WENDY     
BENTON     : SILVA      DEANA      CARMELO    LEANN      GAY        ROTH      
HARMON     : DERICK     BARRERA    TOM        NIKKI      BOWMAN     ROSALINDA  HOFFMAN    MACK      
HARMON     : ROBERTSON 
DIXON      : HARRELL    SARA       PRESTON   
ISABELLA   : BELL       KEVEN      DENNIS     DURAN     
GARNER     : HARRINGTON POOLE     
MOODY      : ERIN       ALEXANDRA  HERSCHEL  
LUISA      : STEFANIE   ROY        MYERS      STANTON    COLLIN     HOFFMAN    CAROL     
PUCKETT    : MARIE      RUSSELL    CORRINE   
WALL       : TIMOTHY    LORRAINE   SOLIS      CALLAHAN  
DEMETRIUS  : SILVA      FRIEDA     JULIET    
MOHAMED    : SIMONE     FUENTES    DUFFY     
GIBSON     : TAMMI      TANIA      CURTIS    
SOLOMON    : STOUT      SHEPHERD  
GOOD       : LES        TREVINO    SALAZAR    SHAWN      SWANSON    DAVID      MERCER    
ELVA       : ODOM       CHARLES   
NIEVES     : THELMA     CLINT      MCGOWAN   
JEWELL     : COX        NAVARRO    MERRITT    BLAIR     
JOSE       : WARREN     ABRAHAM    DONNA      SUSAN      JOAN       BEASLEY   
DIXIE      : MARION     VONDA      WELLS     
GRAY       : JILL       BARTLETT   DIANE      AMADO     
FULLER     : FIELDS     ASHLEY     KAUFMAN    BATTLE     NATASHA   
ELDON      : HARRINGTON MCCARTHY   KRISTINA   CONRAD    
JESSICA    : LARSEN     LEWIS      MONTOYA   
GILLESPIE  : JOY        JOANNA     ALICIA     KELLER    
ALEXANDRA  : CRISTINA   FOSTER     MOODY      SCHROEDER  MADDEN     BETH      
IRA        : ERIN       SOFIA      STEVENSON  RUSSO     
BIRD       : LYDIA      BOYD       CAROLINE   CHERRY     CONSTANCE 
TAMMIE     : JENNINGS   TAYLOR     DANIELLE   TAMMY     
RORY       : ESTES      ELLIS      RICHARDS   HECTOR     VALENCIA   RONNY      HEWITT    
MERCER     : ROY        STOUT      GOOD      
STANTON    : LOTTIE     AHMED      LUISA      ARTHUR     GIBBS      DANA      
GRACIELA   : ANIBAL     ERIN       OLA        STEFANIE   ROSE       SHEPARD    LINDSAY    STEWART   
GRACIELA   : ELBERT    
COLLIN     : ISSAC      CLEMENTS   NORRIS     NANETTE    LUISA      VALENZUELA LINDSEY   
BOBBI      : FORBES     FARLEY     VEGA      
MARKS      : LAUREN     HAROLD     KARLA      PAT       
ADKINS     : THURMAN    FRANCES    AVERY     
HERMAN     : FLOSSIE   
IRVIN      : MONTY      DARNELL    CLYDE      EDGARDO    ANTONIA   
PATRICK    : MARISOL    ALTA       FIGUEROA   BURCH      ANA       
VALENZUELA : COLLIN     GUZMAN     GRAHAM     MONROE    
WILKERSON  : SUAREZ     KELLEY     ROMAN     
ANTONIO    : BROWN      ESTEBAN    HALL       KYLE       MADDEN    
HERSCHEL   : FLETCHER   LES        MOODY      LEON      
DWIGHT     : LYDIA      SHERYL     MARA       BLANCHARD  FRANCISCO 
HURST      : DALE       MALDONADO  WILFORD   
PAT        : MEREDITH   PETTY      CARROLL    MARKS      CHARLENE  
LAURI      : MCKENZIE   COTE       MCCLURE   
HENRY      : TABATHA    PHILIP     DEANA      BRIANA     JULIE      CLARENCE  
MARSH      : TANYA     
NOEMI      : CRISTINA   ALVIN      VASQUEZ    SHAWN      LAWANDA   
CHRISTIAN  : ELMA       WHITAKER   JOYCE      WILBUR     ERNA      
SHANNON    : HOLDEN     AYERS      AMADO      HAWKINS    ELINOR    
ARNULFO    : HEIDI      SANTANA    TRACY     
SETH       : VERNON     LOTT       WATTS      TERENCE   
INGRAM     : HANNAH     STUART     CORY       HIGGINS    ART        SNOW      
ALFRED     : EUGENIA    VELASQUEZ  MORRIS     PETER      RUSS       HOWELL     JACKSON   
CHRISTINE  : AVIS       PETTY     
CINDY      : PATE       HENDRIX    OMAR       AISHA      WEBB      
DAVENPORT  : LESLIE     LILIANA    BRYON      KERR      
SANFORD    : SILAS      BALLARD   
COLEMAN    : FERN       JOSEPHINE 
JIM        : BALLARD    CONNER    
GENARO     : WEBSTER    REUBEN     CARMINE    ANTONIA    MEADOWS   
CORINNE    : MASSEY     WENDY      ALICIA     HAWKINS    HOWARD    
ELBERT     : DORIS      AMIE       BEACH      GRACIELA   LIDIA     
DAREN      : MOSES      CAMACHO    ROYCE     
YVETTE     : GILL       COLLIER    NETTIE     REINALDO   ONEIL      SELLERS   
MORROW     : ELLIS      JANINE     AISHA      MITCHELL   CASTRO     HELGA     
GUZMAN     : KRISTINA   VALENZUELA
NORMA      : MERCADO    KENT       STEWART   
DAMIAN     : MEREDITH   SCOTT      HERMINIA   ADELINE    VALENTINE 
HUMBERTO   : MCDONALD   BORIS      FRANKLIN  
DICK       : LANA       MACIAS    
SONNY      : VELASQUEZ  DAVIS      LYMAN     
MATHIS     : ALTA       KEVEN      NORA       PALMER    
JULIET     : TYREE      JULIA      DEMETRIUS  GILBERTO  
KRISTEN    : LESTER     BENNIE     NICOLAS   
SARGENT    : VELMA      BONITA     KELLER    
MCCARTY    : WEISS      RICARDO    JACOBS    
TANIA      : DYER       GIBSON     HUDSON    
JULIE      : LUCIANO    CASANDRA   VICTORIA   BRIGITTE   MELBA      HENRY     
RONNY      : RUSS       RORY       ENID      
HENDRICKS  : HEBERT     TAMMY      CASSIE    
BOWMAN     : BALLARD    HENSLEY    LUPE       PACHECO    HARMON    
HARRISON   : KELLER     HOWELL     ANGIE     
DORA       : ROSEANN    CARROLL    LESSIE    
ELIJAH     : GIOVANNI   WOLFE      HICKS      CAROLE    
ERICKSON   : OCONNOR    WILLIAMS   PRESTON    MARCY     
TEDDY      : FANNIE    
REFUGIO    : ABEL       BERNADINE 
LOTT       : LANDON     PATE       ROSE       MOSS       MAE        SETH       CASEY     
WATTS      : BARTLETT   RIOS       STARK      ROSA       SETH      
GILES      : VICKY      DENA       JEAN       MARSHALL   FUENTES   
VAN        : MCKAY      CRYSTAL    MCCALL     LENORE     BRYANT    
BULLOCK    : BRADLY     KELLEY    
GOODWIN    : RICHARD    DOYLE      MITCHELL  
TORRES     : LILA       JIMENEZ    FISCHER    RICE       GARRY      WEEKS      CANTU     
WALLER     : STEPHENS   NEWMAN     JOSEPH     HOLLOWAY   PETERSEN  
RAPHAEL    : WHITE      GEORGIA   
ELLIOTT    : CHANEY     ALTA       HOUSE      JEANNE     MORENO    
MACDONALD  : CARISSA    SAVAGE    
JAMAR      : VELMA      BEST       DENA      
LEMUEL     : MCCARTHY   SHIRLEY    PARSONS   
DARIN      : HOLT       FRANCIS   
ROJAS      : CANDICE    JODIE      SOSA       ROBERT    
BOYLE      : MARION     MONICA     FOX        CHAN       ALFONSO   
KENTON     : DORIS      YOUNG      JACKSON   
MOISES     : CONNIE     NAPOLEON  
AUTUMN     : FULTON     JILLIAN   
ROOSEVELT  : MILLIE     ROSALINDA  REGGIE    
QUINN      : MARISOL    MARIE      PHILIP    
NAVARRO    : RICARDO    JEWELL     CASTRO    
FAITH      : FIELDS     MONTGOMERY HOLDEN     MARIANO   
CAIN       : VERA       HEBERT     RAY        FRANCISCO 
CHANCE     : OCTAVIO    REBEKAH    STUART     MARYELLEN  HOGAN      BEASLEY   
BRANDI     : WILLIS     IAN       
ROSALINDA  : HARMON     ROOSEVELT 
PATSY      : SARA       STARK      BUDDY     
SOSA       : JACLYN     ROJAS     
HODGE      : MARISOL    NUNEZ      DENIS      DAVIS      SALINAS   
NANCY      : PRISCILLA 
LON        : JANELLE    JARED      FRANKIE    BRAY      
TERRELL    : MERLIN     OTIS      
MERRITT    : GLORIA     JEWELL     MCCLURE   
MATTHEWS   : ANDY       HOLLAND   
CEDRIC     : LATONYA    GOMEZ      ABRAHAM    NICOLE     LEBLANC    TREVINO   
MAXINE     : HUBER      GRAHAM    
SUSIE      : CASTILLO   ROSALIE    REEVES     SCOTT      PHILLIP    FRANCISCO  TONIA     
HALL       : ANTONIO    EDWIN      ISIDRO     PASQUALE  
ALYSON     : SIDNEY     NEIL       KEVIN     
CHERRY     : JACLYN     AUGUSTINE  BERNADETTE BIRD      
CORTEZ     : BARRY      ANNIE      GONZALO    FARLEY     TERRENCE   SHERRI    
EVAN       : CARMINE    ANA        RUSSO     
PHILLIP    : GARRETT    DYER       SUSIE      ROTH      
SUSANNA    : DEENA      CHERI      RYAN       ORTIZ      ANGIE     
MANNING    : STUART     FRANCIS    RAYMOND    JOAN       LAWANDA   
CARDENAS   : FEDERICO   MABEL      MILDRED    WENDI      RENA      
OTTO       : HURLEY     HUGH       LARSON    
KYLE       : LOWE       ANTONIO    COTTON     VANCE      JOHNSTON  
EARNEST    : BYRD       DARCY     
OLSEN      : BUCKNER    AGNES      SALINAS   
WILLIE     : QUINCY     KIDD       MCCRAY     PHELPS    
SCHROEDER  : DEJESUS    SIDNEY     ART        ALEXANDRA  FUENTES    EVANGELINE
TONI       : CARMINE    WHITFIELD  WALTER     MARISSA   
BILLIE     : JOHNATHAN 
OLSON      : CLEMENTS   SAMPSON    GATES      HARRIET   
ESTELLA    : COPELAND   LEANNE     RICHARDS   GOODMAN    CONNER     ONEIL     
ALBERTO    : BERT       CRAFT      FLORENCE   OMAR       MINNIE    
SHARRON    : DINO       KELLER    
EDWIN      : HOBBS      WYATT      HALL      
WHITNEY    : JOSEPH     TREY      
CURRY      : FIGUEROA   HENRIETTA  LOWE       KEITH      ANASTASIA  DEVON     
HUFFMAN    : HULL       ELISEO     ANDREW     KEVIN     
TERENCE    : IRWIN      FARLEY     SETH       CALVIN    
SANTANA    : ROBLES     HERIBERTO  ARNULFO   
ROMAN      : MANUEL     RODRIQUEZ  WILKERSON 
KENDRA     : KIDD      
PETERSON   : RIOS       SAMUEL     TAMMY      JUANITA    BARR       JAMEL     
ROD        : RODNEY     TREVINO    CHUCK      SAVANNAH  
BASIL      : ROSETTA    ROBBY      CARLO      GOLDIE     GREENE    
RICK       : DEANDRE    MICHEAL   
MICHAEL    : EUGENIA    JEREMY     WENDY     
BATTLE     : PEARSON    MARCELINO  TOM        KRISTINA   FULLER    
COTTON     : LUCILLE    IAN        KYLE      
BERNARDO   : CECIL      SERGIO     SONYA      ALICIA     VANCE      RANDOLPH  
WASHINGTON : MAYNARD    TANNER     TRENT     
JILLIAN    : WENDY      AUTUMN     SCHWARTZ  
TERRENCE   : HOOPER     MADELINE   CORTEZ     JOAN       WEBB      
HERRING    : ABEL       TREY       SALINAS   
FREDERICK  : FLORES     KURT       ERNESTINE  NOELLE     CASEY     
DYLAN      : JOHNATHAN  BOLTON     KIDD      
SIMPSON    : DAVIS      TAMMI      LACEY     
BRADFORD   : ART       
ERIK       : AVIS       MOSES      HILARIO    GINGER    
CALVIN     : WALSH      CAMERON    TERENCE    DON        GIBBS     
MARIANO    : BARNES     ROCCO      WOLFE      MURIEL     VICKI      EARLE      FAITH      HOWELL    
BARR       : NEWMAN     MEDINA     STEVENS    JEREMY     PETERSON  
ORTIZ      : FLOSSIE    CAMERON    JARED      SUSANNA    INA        GALLAGHER 
DON        : DIAZ       CALVIN     GRAHAM    
THADDEUS   : ETTA       ROY        TIMOTHY    KASEY     
SCHWARTZ   : MCCULLOUGH LOURDES    HOLT       JILLIAN   
AYALA      : HUBER      HEIDI      ORR        WALLS      NIELSEN   
HUDSON     : ROBERTA    ERIKA      TANIA     
TRUDY      : MADELINE   WALTERS    GLADYS     SIDNEY    
ARTHUR     : ROSETTA    STANTON    DELBERT   
COFFEY     : WEEKS      RANDOLPH  
MAYER      : HOLDEN     COPELAND   HURLEY     NANETTE   
NADINE     : BALLARD    NANETTE   
DUNCAN     : KNOX       JAIME      CAROLYN    PARK       SIMONE     BRUNO     
REGGIE     : NICOLE     HORN       HULL       ENGLISH    ROOSEVELT 
BLAIR      : HEBERT     MAE        PUGH       JEWELL    
SHERMAN    : DODSON     BOLTON    
LENORA     : HORTON     JOANNA     ROXANNE    REYNA      LACEY     
CHUCK      : POPE       ROD       
GATES      : HERBERT    DODSON     MARGARITA  NORRIS     OLSON      ELINOR     RUSSO     
SOFIA      : EDMUND     FLORES     IRA        BOWEN     
FERDINAND  : GOLDIE     REGINA    
ISIDRO     : DODSON     KIM        HALL      
KELLER     : CARSON     SILAS      SCOTT      AUGUSTINE  FAULKNER   GILLESPIE  SARGENT    HARRISON  
KELLER     : SHARRON    RANDALL   
CANDY      : FIGUEROA   FERRELL   
JAY        : SLOAN      MOLINA     ALVAREZ    ANGIE     
TURNER     : LEVI       ALISSA     MCMAHON   
MUNOZ      : MCINTYRE  
VARGAS     : ROBLES     HOOD       JACKSON   
WENDI      : STACIE     CARDENAS   WEBB       LORAINE   
RANDALL    : MEREDITH   HIRAM      MOSS       CARLO      KELLER     STACY      RUSSEL    
JOAN       : SCHNEIDER  TOMMY      JOSE       MANNING    TERRENCE  
ERNA       : FROST      ROBT       CHRISTIAN  ALBERT    
VANCE      : MARGARITO  KYLE       BERNARDO  
AMADO      : WILCOX     GRAY       SHANNON   
CARVER     : RASMUSSEN  BARNETT   
LACEY      : SIMPSON    LENORA    
INA        : ORTIZ     
HARRIET    : ROBERTA    BUCK       KATHLEEN   RUSS       OLSON      DALTON    
AISHA      : BRENDAN    CINDY      MORROW     CASEY      ANNABELLE 
ALI        : LARSEN     KERI      
FORREST    : VALERIE    ANNMARIE  
ADDIE      : LUCILLE    KERI       NOELLE     COLLEEN    ROTH      
GALLAGHER  : SCHNEIDER  ROMERO     ORTIZ     
KNIGHT     : CHAN       LOTTIE     KEVEN      SIMONE    
KRISTINE   : KRISTOPHER MERLIN    
ROBERT     : LEONOR     ANDERSON   ROJAS     
CLARENCE   : MCKENZIE   FRANKS     SAMUEL     HENRY      MARSHALL   CLAUDIA   
WHITE      : HANSON     URSULA     GLADYS     JARRED     RAPHAEL   
KERRI      : ROBBIE     LEWIS      BRIGGS    
HOFFMAN    : MEREDITH   NUNEZ      CHAN       ROSARIO    HARMON     LUISA     
TABITHA    : DONNY      INGRID     DEANNE    
DURAN      : AL         ISABELLA   ANDREW    
CORNELIUS  : BRENDAN    CHARMAINE  MAURICE   
HOWELL     : SEARS      MILLIE     ROSA       ALFRED     HARRISON   MARIANO   
CHARMAINE  : ROSALIE    AURORA     CORNELIUS  BETH       MCMAHON   
ERNIE      : ARMSTRONG  NANETTE    VIRGIE     FRANKIE   
MARSHALL   : PATE       GILES      CLARENCE   MAYNARD    JOYNER    
HOOD       : COLON      GABRIELA   IAN        VARGAS    
HARRIS     : REUBEN    
FRANKIE    : LEONARD    LON        ERNIE     
LAWSON     : MCFADDEN   WILEY      EDGARDO    OMAR       NATASHA   
DEWITT     : SNOW      
LEON       : BOYD       EARLE      HERSCHEL  
SANCHEZ    : ANNA       ANNETTE   
GONZALES   : WILLARD    CARSON     IGNACIO   
JEANNE     : TILLMAN    ERIN       HUNTER     ELLIOTT    ANDREW    
LIDIA      : JOHNS      GILL       ELBERT    
CUMMINGS   : JOY        ODOM       THURMAN    DAWN       ERICKA     NIKKI     
HAWKINS    : IRIS       MARIANA    JOSUE      SHANNON    CORINNE    GREENE    
LE         : DENNIS     AVERY      WILLIAMS   JOHNSTON   KERR      
ANASTASIA  : FORBES     ROXANNE    MARTINEZ   MABEL      CURRY     
ROYCE      : WITT       BRYON      SEARS      BETHANY    DAREN      GEORGIA   
BURKS      : CRISTINA   YANG       HUGHES     FUENTES   
FLYNN      : HANNAH     ODOM      
DALTON     : SELENA     CLAUDETTE  GARRY      ROSEMARY   HARRIET    LAWANDA   
STRONG     : PAGE       FREDERIC   NITA      
CLINT      : FREDDIE    CONTRERAS  DONALD     NIEVES    
LORNA      : BENNIE     CUNNINGHAM THOMPSON   BOB        PARKS     
ENID       : JARVIS     BENNIE     KERRY      ELIZA      RONNY     
JACKSON    : SYDNEY     RICE       ENRIQUE    BEACH      SERRANO    ALFRED     KENTON     VARGAS    
RICHARDSON : MCNEIL     JANINE     JOSEPHINE 
BRYANT     : VAN        ALBERT     KERR      
CLEMONS    : PENNINGTON LORRAINE   MAURICE    HILL      
CHARLENE   : HART       REYES      PAT       
ROWE       : BARNES     ROBINSON   GRAHAM    
REINALDO   : BURGESS    DECKER     YVETTE    
JOHNNIE    : JENNINGS   LUCIANO   
TANYA      : BETTE      FLETCHER   ARMSTRONG  MARSH      TYLER     
COTE       : MARIE      KIDD       LAURI     
POOLE      : BENJAMIN   HERRERA    LOURDES    GARNER     JULIAN    
ONEIL      : GILMORE    MCCONNELL  MCLAUGHLIN JOHNS      YVETTE     ESTELLA    BLAKE     
HELENA     : PHOEBE     KANE      
HUBBARD    : VALERIE    IRWIN     
MARCEL     : RODRIQUEZ 
BRAY       : TILLMAN    MILES      LON        RENA      
DAMON      : SELENA     BARKER     PARRISH    NEWTON    
AIDA       : OLGA       MOLLIE    
BLAKE      : ALVAREZ    ONEIL     
GEORGIA    : BALLARD    ENRIQUE    RAPHAEL    ROYCE     
NELDA      : HARRELL    GUY       
GRAHAM     : MAXWELL    DARNELL    TREY       KARLA      VALENZUELA MAXINE     DON        ROWE      
HOWARD     : BURGESS    CARISSA    TINA       CORINNE   
STEVENSON  : BYRD       RYAN       SNOW       CAMERON    HICKS      IRA        ALFONSO   
STACY      : BELL       DAPHNE     MYERS      RANDALL   
CAROL      : DEJESUS    LUISA     
MADDEN     : WITT       JANETTE    ALEXANDRA  ANTONIO   
ROSALES    : HEBERT     RICHARD    ROCCO      WINFRED   
ALISSA     : THELMA     MCCULLOUGH CONCEPCION PUGH       ENGLISH    TURNER    
RODERICK   : LANDON     ENRIQUE    ROCKY      MOSLEY     MARCIA    
NOEL       : CONLEY     SHIRLEY   
MCLEAN     : AURELIA    TATE       WELLS      MARVIN    
CONSUELO   : ISIAH      KANE       RAUL       LORAINE   
CARLA      : MEDINA     ABEL       SIDNEY     DYER       HICKS     
KASEY      : LILA       THADDEUS  
MORENO     : CANDICE    RICE       JUANITA    MCINTYRE   CAROLINE   ELLIOTT   
BARNETT    : ETTA       WILL       JERALD     MARCY      CARVER    
ANDREW     : MARYELLEN  WENDY      HUFFMAN    DURAN      JEANNE    
SAVANNAH   : VELASQUEZ  JUSTINE    ROMERO     EVANGELINA ROD       
DUNLAP     : MERCEDES   MACIAS    
MITCHELL   : PITTMAN    FLEMING    MORROW     GOODWIN    LOGAN     
HEWITT     : WELCH      TATE       WELLS      RORY      
BARBRA     : RAMSEY     HANEY      BRIGGS    
JOSH       : DORIS      MASSEY     MACIAS     MONA      
MILO       : COPELAND   IVANA      KNOWLES    RAYMOND   
MACK       : ROSALIE    HARRELL    HARMON     MAURICE   
ODONNELL   : ERIN       REBEKAH    BAIRD      FUENTES    MAYNARD   
JOHNSON    : DANIELLE   WOODWARD  
MINNIE     : WALTERS    SCHULTZ    DUSTY      LUCAS      TAMMY      BUCKLEY    ALBERTO   
CASTRO     : COLON      BARNES     MORROW     NAVARRO   
JAMEL      : OMAR       VEGA       PETERSON  
HOLLOWAY   : BORIS      WALLER    
LANG       : CASTILLO   PAMELA     MILES      CONRAD    
SALVATORE  : PAGE       CHRISTA    CARMELO   
RANDOLPH   : WILCOX     MAGGIE     SERGIO     BERNARDO   COFFEY    
TRAVIS     : NOLAN      LEONARDO   MUELLER   
DEVON      : CAMERON    CURRY     
FRANCISCO  : DWIGHT     CAIN       SUSIE     
CORRINE    : EMORY      CRANE      PUCKETT   
HOGAN      : STOUT      CONTRERAS  WALLS      MASSEY     CHANCE    
DANIEL     : JILL       LETICIA    LUCY       RACHAEL   
ANGELITA   : ROSALIE    CLEVELAND 
MARISSA    : JIMENEZ    FLORES     HAZEL      TONI      
OBRIEN     : ARRON      JOANNA     DENNIS    
WINFRED    : BOBBIE     TREVINO    ROSALES   
CLAUDIA    : MANUEL     CONTRERAS  JANICE     CLARENCE  
GIBBS      : CARLSON    YOUNG      STANTON    CALVIN    
FERRELL    : PAGE       IRIS       MARCI      VERN       CANDY     
ELINOR     : SILVA      BUTLER     SHANNON    GATES     
LUCY       : AVIS       JARED      JOSUE      DANIEL    
GAY        : BRANDY     BENTON    
MOSLEY     : GILMORE    DUSTY      RODERICK   RAUL      
FUENTES    : CALLAHAN   VALENTINE  MOHAMED    GILES      SCHROEDER  BURKS      ODONNELL   BAUER     
JULIAN     : ERNESTINE  JOSUE      POOLE     
PASQUALE   : HUGH       PAYNE      HALL      
LEROY      : GILBERT    CATHERINE  BOB        JEREMY    
DELBERT    : CANDICE    HEATH      KERI       RAY        ARTHUR     LORAINE   
DANIAL     : BENJAMIN   CATHRYN   
PHELPS     : NICOLAS    NIGEL      EDGARDO    WILLIE    
MAYNARD    : NORTON     ASHLEE     WASHINGTON MARSHALL   ODONNELL   TANNER    
JOYNER     : CHARITY    HUGHES     JUAREZ     MARSHALL  
CURTIS     : MANN       DONOVAN    PHILIP     GIBSON    
CONSTANCE  : HERBERT    ROY        JESSIE     MAYS       NEWTON     BIRD      
TANNER     : CARMELO    RICKY      WASHINGTON MAYNARD    TRACY     
KRAMER     : PICKETT    DARYL      FROST      ANNIE      HENDRIX    AURORA     VICKI     
MCGOWAN    : MONICA     DIONNE     ADAMS      NIEVES    
SELLERS    : ROCCO      THURMAN    YVETTE     VAUGHN    
SHELLEY    : DERICK     RAMOS      PITTS      FEDERICO   MORRIS     AUBREY     KEITH     
ALFONSO    : ANTONIA    JOSUE      BOYLE      STEVENSON 
CROSBY     : WILEY     
PARSONS    : CHRISTA    ROMERO     LEMUEL    
HELGA      : BARTLETT   SANDOVAL   MORROW    
ALINE      : ABRAHAM    PIERCE     TOWNSEND   ETHEL     
GALLOWAY   : LOIS       HAMILTON  
LINDSEY    : MCLEOD     FOREMAN    COLLIN    
JOSEPHINE  : ABE        COLEMAN    RICHARDSON
BERNADINE  : ANITA      SEARS      REFUGIO   
OWEN       : MCKAY      WARNER     LAMBERT   
CASEY      : BRANDY     MCCALL     LOTT       FREDERICK  AISHA     
TYLER      : LANDON     WOLFE      FRANCESCA  SWANSON    TANYA     
MARCIA     : WALSH      GRETA      ED         RODERICK   MARTIN    
COLLINS    : OCTAVIO    CROSS      LULU       AL         DARRYL    
MONROE     : MCDONALD   ALLISON    MARCUS     VALENZUELA
MARVIN     : PARK       ROSS       WELLS      MCLEAN    
DUFFY      : GRIMES     GOODMAN    VERNON     MOHAMED   
JOHNSTON   : SHEPARD    BENITO     KYLE       LE        
KELLY      : HIRAM      HARRELL    BEAN       JOHNATHAN  THOMPSON  
RUSSO      : DARCY      IRA        EVAN       GATES     
BRIDGET    : PHOEBE     WHITLEY    CLYDE      CANTU     
LYNN       : WEBSTER    MERCEDES   BROCK      EVERETT    NITA      
BEASLEY    : TUCKER     BENITO     JOSE       CHANCE     RUSSEL    
ETHEL      : PITTMAN    ALINE     
MACIAS     : WALTON     MARION     RAMOS      HENDRIX    DICK       DUNLAP     JOSH      
FINLEY     : GILL       SCHULTZ    GREENE    
BARTON     : ANNA       TODD       MARIA      ALTON      RUSSELL    JEREMY    
RUSSEL     : MCNEIL     FRIEDA     CONRAD     JUANITA    RANDALL    BEASLEY   
PALMER     : LENORE     DENA       AVA        MATHIS    
GLOVER     : PETTY      CHERI      JIMMIE     ROSEMARY  
LAWANDA    : SHERYL     SUSAN      NOEMI      MANNING    DALTON    
EVE        : SPENCE     AGNES      VERN      
GILBERTO   : JULIET     DARRYL    
LLOYD      : PERRY      JANELLE   
HEAD       : PERRY      ARMSTRONG  WHITFIELD  TATE      
PARKS      : TOBY       JANICE     LORNA      BRYAN      LORAINE   
MARTIN     : RAMSEY     EMORY      MALLORY    JEAN       MARCIA    
SAVAGE     : SANTIAGO   BROCK      VALENTINE  MACDONALD 
MAURICE    : ROSA       MCCORMICK  CORNELIUS  CLEMONS    MACK      
STEPHENSON : MERLE     
NICHOLSON  : FIELDS     JOYCE      BEACH      JUAREZ     ISIAH     
BRIGGS     : IRWIN      JOSEPH     TATE       KERRI      BARBRA    
REYNOLDS   : PECK       BOYER     
REILLY     : JANELLE    FRYE       RODGERS    RUSSELL   
EVANGELINE : SCHROEDER  ALBERT    
BRYAN      : BLACKWELL  SWEET      FREDERIC   JACLYN     GILL       PARKS     
NGUYEN     : PHILIP     HENDRIX   
WEBB       : CALDWELL   CINDY      TERRENCE   WENDI     
ROTH       : CARLENE    ROSS       BENTON     PHILLIP    ADDIE     
KANE       : MARGARITA  KERRY      MARCI      HOLLIE     EVERETT    LORIE      HELENA     CONSUELO  
ALBERT     : ERNA       BRYANT     EVANGELINE
LESSIE     : DONA       HICKS      DORA      
ANGIE      : ROSEMARY   HARRISON   SUSANNA    JAY       
DEAN       : JACKIE     ERIKA      VICKY      NAPOLEON   HAYS       POLLARD   
MCCLURE    : HUGHES     LAUREL     LAURI      MERRITT   
STANLEY    : CRAFT      ELOISE     VAUGHN    
MCBRIDE    : TREVINO    AVA       
HUNT       : CARNEY     JOHNS      AURORA     TRACY     
BETH       : AVIS       LOIS       CRAFT      CONNER     ALEXANDRA  CHARMAINE 
RENA       : AUSTIN     JULIO      CARDENAS   BRAY      
ROBERTSON  : BARLOW     DIANE      CANTU      HARMON    
KEVIN      : JOHN       STEELE     RODRIGUEZ  MARTHA     JUAREZ     ALYSON     HUFFMAN   
KRYSTAL    : TRICIA     BARBER     ERMA      
WELDON     : YANG       RONALD     JANETTE    EMILY     
ESTRADA    : LEE       
GREENE     : SAMUEL     NAPOLEON   SANDOVAL   BASIL      HAWKINS    FINLEY    
MCMAHON    : AGNES      FLOYD      BRIGHT     TURNER     CHARMAINE 
TRENT      : BARLOW     WASHINGTON
REGINA     : ANNIE      HENRIETTA  HAZEL      FERDINAND 
POLLARD    : MICAH      RASMUSSEN  DEAN      
QUINTON    : WARD       OLA        DAVID     
CAROLE     : TOWNSEND   ELIJAH    
HOLLAND    : WILLARD    JODIE      MATTHEWS  
KERR       : ODESSA     RASMUSSEN  FRANCESCA  ESTEBAN    DAVENPORT  LE         BRYANT    
DARRYL     : GOLDIE     KIDD       COLLINS    GILBERTO   SHERRI    
CHARLES    : LENORE     RODGERS    REYNA      JERALD     ROSARIO    ELVA      
LOGAN      : LUCIEN     LEE        BEST       MITCHELL  
CASSIE     : KENDALL    MOLINA     CARR       HENDRICKS 
BOWEN      : DARYL      MASSEY     SOFIA      RACHAEL   
HARPER     : GILMORE   
FRANKLIN   : TRENTON    SCOTT      HUMBERTO  
WONG       : JACKIE     JACLYN     LEBLANC   
MERRILL    : ESTES      CLEVELAND 
MONA       : KATHERINE  VEGA       JOSH      
TONIA      : LEONOR     DELORIS    SUSIE     
DANA       : NIGEL      RODRIQUEZ  TINA       STANTON   
ANNABELLE  : LUCIEN     ROBIN      TINA       ALICIA     AISHA      RAUL      
TY         : OCONNOR    TAYLOR     KATHY      RONALD     BUCHANAN   JEAN      
HILL       : LILA       WARREN     CLEMONS   
BAUER      : BARRERA    FUENTES   
TRACY      : CRAFT      TAMMI      JONI       ARNULFO    TANNER     HUNT      
HAYDEN     : ANNA       TOM        PETER     
NATASHA    : EUGENIA    MCKENZIE   ANNMARIE   FULLER     LAWSON    
RAUL       : GUTHRIE    CONSUELO   MOSLEY     ANNABELLE 
VAUGHN     : PEARSON    BOB        STEVEN     SELLERS    STANLEY   
LORAINE    : WENDI      CONSUELO   DELBERT    PARKS     
RACHAEL    : KURT       ROSS       PRISCILLA  DANIEL     BOWEN     
SHERRI     : LANGLEY    EFREN      CORTEZ     DARRYL    
PETERSEN   : VERA       FOWLER     SHIRLEY    GARZA      WALLER    
